11111111111111111111
1000000000C000000001
10C00000000000000001
1000100C00000C000001
10001000000000111111
10001000000000000001
11111110000000000001
100000000000C0000001
10001111000000000001
1000000000000000E0P1
11111111111111111111